12,12
3 3 3 3 3 3 3 3 3 3 3 3 
3 1 0 0 0 3 0 0 0 0 1 3 
3 1 0 0 5 3 5 0 0 0 1 3 
3 0 0 0 0 3 0 0 0 0 0 3 
3 0 0 0 0 3 0 0 0 0 0 3 
3 4 3 3 3 3 3 3 3 3 4 3 
3 0 0 0 0 3 5 0 0 0 0 3 
3 0 0 0 0 4 0 0 0 0 0 3 
3 0 0 0 0 3 0 0 0 0 0 3 
3 0 0 0 0 3 0 0 0 0 0 3 
3 0 0 0 0 3 0 0 0 2 2 3 
3 3 3 3 3 3 3 3 3 3 3 3 
